NO ./imgs/nature_04.png
SO ./imgs/nature_01.png
EA ./imgs/nature_03.png
WE ./imgs/nature_02.png

F 171,181,187
C 50,50,52

    111111111111111    11111111111111
    100000000000111    10000000000001
    100000000000111    10000000000001
    100000000000111    10000000000011
    100000000000111111110000000000011111111111111
    10000000000000000000000000000000000000000001
    10000000000000011111111110000000000000000001
    11111100000000011      110000111111000000001
    10000100000000001      100000000000000000001
    10000100000000001      100000000000000000001
    10000100000000001      100000001100000000001
    10000000000000001      100000001100000000001
    10000100000000001      100000001100000000001
111111111100000000001      100000001100000000001
111111111100000000001      100000001100000000001
111111110000000000001      100000001100000000001
100000010000000000001      100000001100000000001
100000010000000000001      100000001100000000001
100000010000000000001      100000001100000000001
111110010000000000001      100000001100000000001
100000010000000000001      100000001100000000001
100000000000000000001      100000001100000000001
111111111100000000001      100000001100000000001
         100000000001      100000001100000000001
         100000000001      100000001100000000001
         100000000001      100000001100000000001
         100000000001      100000001100000000001
         100000000111      100000001100000000101
         100000000111111111100000011111100000001
         100000000111111111100000000100000111111
         100000000111111111100000000100000111111
         100000000111111111100000000100000000001
         100000000000000000000000000000000100001
         10000000000000N000000000000000000111111
         111111111111111111111111111111111111111