NO ./imgs/nature_04.png
SO ./imgs/nature_01.png
EA ./imgs/nature_03.png
WE ./imgs/nature_02.png

C 9,24,51
F 48,27,104

111111111111
100000000001
101000110111
101001000001
100011111001
100000000001
100111111001
1000000000W1
100000000001111111111
100000000000000000001
100000111000000000001
100000000001111111111
111111111111