NO ./imgs/nature_04.png
SO ./imgs/nature_01.png
EA ./imgs/nature_03.png
WE ./imgs/nature_02.png

C 9,24,51
F 48,27,104

1111111111111111111111
1000000000000000000001
1000000000100000000001
1000000001010000000001
1000000010N01000000001
1000000001010000000001
1000000000100000000001
1111111111111111111111
